     

    
NO ./assets/xpm/wall/temple_north.xpm
SO ./assets/xpm/wall/temple_south.xpm
WE ./assets/xpm/wall/temple_west.xpm
EA ./assets/xpm/wall/temple_east.xpm
F 120,120,120

C 0,0,0

        1111111111111111111111111
        100000000F11000L00M00F001
        10110000011100C0000000001
        10F1F0C0M0D0000M000C00001
11111111101100000111000L00M000F01
1F0000000M11F0M00F11D111111111111
11110111111111011100000F10F01
1111D111111111D11101010010C01
110F0F0011F1F10111M0C0M010M01
1F00C0000M00C00F11000000D0001
1F00000000000M0F11F1C1F010M01
11000001110101011111M11110C0111
1111N11  111F1F1 10111101FTF1
11111111 1111111 111111111111