NO ./assets/xpm/wall/default_north.xpm
SO ./assets/xpm/wall/default_south.xpm
WE ./assets/xpm/wall/default_west.xpm
EA ./assets/xpm/wall/default_east.xpm

F 255,0,255
C 255,255,0

111111111111111
100000000000001
100000000000001
100000000000001
100000100000001
100001S00000001
100000000000001
100000000000001
100000000000001
100000000000001
100000000000001
100000000000001
100000000000001
100000000000001
111111111111111