NO ./assets/xpm/wall/default_north.xpm
SO ./assets/xpm/wall/default_south.xpm
WE ./assets/xpm/wall/default_west.xpm
EA ./assets/xpm/wall/default_east.xpm
F 220,100,0
C 225,30,0



   
    
     
        1111111111111111111111111
        1000000000110000000000001
        111111111111111111111111111
        111111111111111111111110
        1011000001110000000011111111111
        100001111111111111111111111111
        1001000000000000000000001
111111111011000001110000000000001
100000000011000001110111111111111
11110111111111011100000010001
11111111111111011101010000001
11000000110101111100000010001
00000000000000001100000010001
10000000000000001101010010N01
110000011101010111110111100111
11110111 1110101 101111010001
11111111 1111111 111111111111