NO ./assets/xpm/wall/default_north.xpm
SO ./assets/xpm/wall/default_south.xpm
WE ./assets/xpm/wall/default_west.xpm
EA ./assets/xpm/wall/default_east.xpm

F 255,0,255
C 255,255,0

F11111111111111
1FFFFFFFFFFFFF1
1FFFFFFFFFFFFF1
1FFFFFFFFFFFFF1
1FFFFF1FFFFFFF1
1FFFF1SFFFFFFF1
1FFFFF0FFFFFFF1
1FFFFF0FFFFFFF1
1FFFFFMFFFFFFF1
1FFFFFFFFFFFFF1
1FFFFFFFFFFFFF1
1FFFFFFFFFFFFF1
1FFFFFFFFFFFFF1
1FFFFFFFFFFFFF1
111111111111111