NO ./assets/xpm/wall/temple_north.xpm
SO ./assets/xpm/wall/temple_south.xpm
WE ./assets/xpm/wall/temple_west.xpm
EA ./assets/xpm/wall/temple_east.xpm

F 120,120,120
C 0,0,0




      
        
        1111111111111111111111111
        100000000F11LFLFLFLFLFLF1
        101100000111M0C0MC00C00F1
        10F1F0C000D000CM0C00C0WF1
11111111101100000111LFLFLFLFLFLF1
1F0000000011F0M00F11D111111111111
11110111111111011100000F10F01
1111D111111111D11101010010C01
110F0F0011F1F1011100C00010001
1F00C00000000C0F11000000D0001
1F000M00000000F11F1C1F010001
110F0F01110101011111011110C0111
1111T111 111F1F1 10111101FTF1
11111111 1111111 111111111111